Крюков Валерий Александрович	m
Малышкин Олег Александрович	m
Венгеровский Александр Дмитриевич	m
Бударин Николай Михайлович	m
Горовцов Дмитрий Евгеньевич	m
Литвинцев Дмитрий Алексеевич	m
Саетгалиев Зифкат Исламович	m
Сафиуллин Фандас Шакирович	m
Нилов Ярослав Евгеньевич	m
Кондратов Руслан Викторович	m
Лазуткин Виктор Александрович	m
Иванов Владимир Павлович	m
Туманов Андрей Владимирович	m
Говоров Леонид Владимирович	m
Меликьян Геннадий Георгиевич	m
Собко Сергей Васильевич	m
Самойлов Евгений Александрович	m
Морозов Андрей Андреевич	m
Ойнвид Григорий Михайлович	m
Иванов Юрий Павлович	m
Казанков Иван Иванович	m
Фейгин Марк Захарович	m
Бычкова Евдокия Ивановна	f
Акбаев Азрет Алиевич	m
Шелищ Петр Борисович	m
Сулейменов Ибрагим Абдурахманович	m
Шубина Татьяна Ивановна	f
Швецова Людмила Ивановна	f
Хайруллин Айрат Назипович	m
Михалев Борис Владимирович	m
Гуцериев Саит-Салам Сафарбекович	m
Кузнецов Василий Федотович	m
Драпеко Елена Григорьевна	f
Братищев Игорь Михайлович	m
Моисеев Михаил Алексеевич	m
Потапов Сергей Александрович	m
Натхо Разиет Хамедовна	f
Руденко Андрей Викторович	m
Сычев Сергей Владимирович	m
Абельцев Сергей Николаевич	m
Сергиенко Валерий Иванович	m
Бурков Сергей Васильевич	m
Орлов Вадим Иванович	m
Побединская Людмила Васильевна	f
Киекбаев Мурат Джелилович	m
Савельев Дмитрий Владимирович	m
Куевда Григорий Андреевич	m
Борзова Ольга Георгиевна	f
Снежков Михаил Николаевич	m
Кочегура Анатолий Тимофеевич	m
Золочевский Виталий Сергеевич	m
Журова Светлана Сергеевна	f
Шойгу Лариса Кужугетовна	f
Попов Андрей Анатольевич	m
Друсинов Валентин Дмитриевич	m
Микулин Вячеслав Викторович	m
Андреев Алексей Петрович	m
Бесчетнов Константин Викторович	m
Суровов Сергей Борисович	m
Крупчак Владимир Ярославович	m
Крутов Андрей Дмитриевич	m
Богомольный Евгений Исаакович	m
Москалькова Татьяна Николаевна	f
Канчер Сергей Васильевич	m
Мень Михаил Александрович	m
Афанасьева Елена Владимировна	f
Мананников Владимир Николаевич	m
Лукин Владимир Петрович	m
Москалец Александр Петрович	m
Мархаев Вячеслав Михайлович	m
Назмеев Юрий Гаязович	m
Романов Антон Васильевич	m
Похмелкин Виктор Валерьевич	m
Митюков Михаил Алексеевич	m
Кобзон Иосиф Давыдович	m
Козловский Александр Александрович	m
Мальцев Александр Николаевич	m
Решульский Сергей Николаевич	m
Мукабенова Марина Алексеевна	f
Шемякин Владимир Леонидович	m
Шайхутдинов Рифат Габдулхакович	m
Орланов Георгий Борисович	m
Султанов Шамиль Загитович	m
Маргелов Виталий Васильевич	m
Бессонов Владимир Иванович	m
Багишаев Зайнулла Абдулгалимович	m
Кондаков Николай Яковлевич	m
Агузаров Тамерлан Кимович	m
Останин Валерий Сергеевич	m
Рыжков Владимир Александрович	m
Гришин Василий Дмитриевич	m
Абубакиров Ришат Фазлутдинович	m
Соломатин Егор Юрьевич	m
Эм Юрий Павлович	m
Рокицкий Михаил Рафаилович	m
Бурлаков Михаил Петрович	m
Слипенчук Михаил Викторович	m
Новиков Дмитрий Георгиевич	m
Рашкин Валерий Федорович	m
Селезнёв Геннадий Николаевич	m
Галимарданов Марсел Магфурович	m
Чуров Владимир Евгеньевич	m
Белов Юрий Павлович	m
Красных Алексей Иванович	m
Брусницын Юрий Александрович	m
Чехоев Анатолий Георгиевич	m
Калашников Сергей Вячеславович	m
Казаков Алексей Валерьевич	m
Клюкин Александр Николаевич	m
Коржаков Александр Васильевич	m
Храмов Рэм Андреевич	m
Исаев Юрий Олегович	m
Аничкин Иван Степанович	m
Муксинов Ирек Шарифович	m
Кодзоев Башир Ильясович	m
Митрохин Сергей Сергеевич	m
Саркисян Ашот Григорьевич	m
Волков Алексей Николаевич	m
Яковлева Татьяна Владимировна	f
Иванов Николай Николаевич	m
Селимханов Магомед Саламович	m
Романов Петр Васильевич	m
Чуньков Юрий Иванович	m
Никитин Валентин Иванович	m
Терешкова Валентина Владимировна	f
Парахин Владимир Вячеславович	m
Марков Валерий Петрович	m
Тетерин Василий Николаевич	m
Карташов Владимир Петрович	m
Ильясов Радик Сабитович	m
Бигнов Рамиль Имамагзамович	m
Ветров Константин Владимирович	m
Якуш Михаил Михайлович	m
Нарышкин Сергей Евгеньевич	m
Памфилова Элла Александровна	f
Кущенко Виктор Николаевич	m
Куликов Виктор Георгиевич	m
Волков Юрий Николаевич	m
Выборный Анатолий Борисович	m
Козырев Андрей Владимирович	m
Журко Василий Васильевич	m
Онищенко Ольга Владимировна	f
Захаров Андрей Александрович	m
Смирнов Вячеслав Михайлович	m
Меремянин Константин Георгиевич	m
Гамидов Гамид Мустафаевич	m
Шохин Александр Николаевич	m
Савельев Андрей Николаевич	m
Большаков Вадим Иванович	m
Денисов Николай Григорьевич	m
Сметанкин Евгений Александрович	m
Водолацкий Виктор Петрович	m
Матханов Владимир Эдуардович	m
Васильцов Сергей Иванович	m
Колесников Сергей Иванович	m
Чуркин Геннадий Иванович	m
Уткин Олег Васильевич	m
Лакутин Николай Афанасьевич	m
Михайлов Вячеслав Федорович	m
Козырев Александр Иванович	m
Скрипицына Раиса Ивановна	f
Пехтин Владимир Алексеевич	m
Киреев Антон Валерьевич	m
Кондауров Алексей Петрович	m
Петров Юрий Александрович	m
Кажлаев Мурад Магомедович	m
Морозов Александр Владимирович	m
Доровских Андрей Михайлович	m
Садчиков Георгий Михайлович	m
Комарова Наталья Владимировна	f
Вульф Андрей Юрьевич	m
Губенко Николай Николаевич	m
Галушкин Василий Иванович	m
Ванчугов Роман Анатольевич	m
Симагин Владимир Александрович	m
Буренин Андрей Викторович	m
Бадалов Рубен Михайлович	m
Катренко Владимир Семенович	m
Бердникова Нина Владимировна	f
Полдников Юрий Иванович	m
Горюнов Евгений Владимирович	m
Гвоздарев Владимир Захарович	m
Маркин Эдуард Витальевич	m
Родионов Игорь Николаевич	m
Абдулбасиров Магомедтагир Меджидович	m
Гончаров Николай Владимирович	m
Чиркова Ирина Александровна	f
Казаковцев Владимир Александрович	m
Изотова Галина Сергеевна	f
Захарова Светлана Юрьевна	f
Лысенко Владимир Николаевич	m
Исаков Игорь Анатольевич	m
Викторов Иван Кириллович	m
Подгурский Александр Михайлович	m
Глебова Любовь Николаевна	f
Сулакшин Степан Степанович	m
Иванюженков Борис Викторович	m
Саблин Дмитрий Вадимович	m
Савельев Юрий Петрович	m
Ашлапов Николай Иванович	m
Медведев Владимир Сергеевич	m
Авдеев Михаил Юрьевич	m
Емельянов Алексей Михайлович	m
Данилова Нина Петровна	f
Лездиньш Айварс Янович	m
Данченко Борис Иванович	m
Ремнева Надежда Степановна	f
Сайкин Валерий Тимофеевич	m
Дубровин Сергей Иннокентьевич	m
Петошин Владимир Анатольевич	m
Демин Владислав Анатольевич	m
Тихонов Владимир Ильич	m
Рахматуллина Зугура Ягануровна	f
Астафьев Николай Павлович	m
Аверчев Владимир Петрович	m
Асаев Раис Бадыгутдинович	m
Коптев-Дворников Владимир Евгеньевич	m
Заварзин Виктор Михайлович	m
Ярыгина Татьяна Владимировна	f
Шихсаидов Хизри Исаевич	m
Гусман Юлий Соломонович	m
Игнатьев Кирилл Борисович	m
Голиков Георгий Георгиевич	m
Эркенов Ахмат Чокаевич	m
Косоуров Виктор Семенович	m
Терентьев Михаил Борисович	m
Коробов Сергей Александрович	m
Беляев Леонид Анатольевич	m
Петров Юрий Юрьевич	m
Нестеренко Татьяна Геннадьевна	f
Селюнин Василий Илларионович	m
Коробов Максим Леонидович	m
Кошева Виолетта Константиновна	f
Степашин Сергей Вадимович	m
Сальников Виктор Иванович	m
Алферов Жорес Иванович	m
Мамонов Юрий Васильевич	m
Савельев Дмитрий Иванович	m
Васильев Александр Геннадьевич	m
Линник Виталий Викторович	m
Кузнецов Михаил Варфоломеевич	m
Мурга Андрей Юрьевич	m
Зайцев Александр Николаевич	m
Лукьянова Кира Александровна	f
Шубин Александр Валентинович	m
Аушев Мухарбек Измаилович	m
Ефремов Павел Васильевич	m
Лебедев Игорь Владимирович	m
Тараканов Павел Владимирович	m
Квасов Владимир Петрович	m
Миронов Олег Орестович	m
Нюдюрбегов Асан Нюдюрбегович	m
Красников Дмитрий Федорович	m
Тарнаев Александр Петрович	m
Петровский Леонид Николаевич	m
Маевский Леонид Станиславович	m
Поляков Юрий Александрович	m
Тарасюк Василий Михайлович	m
Бондарев Григорий Семенович	m
Попова Екатерина Михайловна	f
Пушков Алексей Константинович	m
Родин Владимир Романович	m
Прозоровский Валерий Владимирович	m
Голов Анатолий Григорьевич	m
Езубов Алексей Петрович	m
Гребенников Валерий Васильевич	m
Борисенко Николай Иванович	m
Зорькин Вячеслав Алексеевич	m
Пискунов Александр Александрович	m
Грачев Владимир Александрович	m
Кузин Валерий Владимирович	m
Гасанов Магомедкади Набиевич	m
Романчук Антонина Ивановна	f
Ермакова Эльвира Леонидовна	f
Коломейцев Николай Васильевич	m
Маркелов Леонид Игоревич	m
Поляков Андрей Александрович	m
Исаев Ризвангаджи Абдулаевич	m
Делимханов Адам Султанович	m
Скум Дмитрий Александрович	m
Тяжлов Анатолий Степанович	m
Юшенков Сергей Николаевич	m
Вшивцев Владимир Сергеевич	m
Ненашев Михаил Петрович	m
Ионов Анатолий Васильевич	m
Петренко Сергей Васильевич	m
Мартюшов Сергей Николаевич	m
Шипов Александр Борисович	m
Бариев Марат Мансурович	m
Иванова Светлана Васильевна	f
Оськина Вера Егоровна	f
Кожухова Валентина Васильевна	f
Сибагатуллин Фатих Саубанович	m
Нисневич Юлий Анатольевич	m
Эренбург Владимир Александрович	m
Огоньков Алексей Валентинович	m
Зеленин Владимир Михайлович	m
Новиков Владимир Ильич	m
Табачков Николай Ильич	m
Максимов Евгений Васильевич	m
Тихонов Владимир Агеевич	m
Мосякин Иван Яковлевич	m
Васильев Николай Иванович	m
Косых Михаил Федорович	m
Кнорр Андрей Филиппович	m
Ушаков Дмитрий Владимирович	m
Улас Владимир Дмитриевич	m
Ледник Виталий Владимирович	m
Клюс Виктор Александрович	m
Чухраёв Александр Михайлович	m
Добровольская Марина Карамановна	f
Косых Владимир Иванович	m
Васильев Иван Афанасьевич	m
Демчук Николай Васильевич	m
Топилин Виктор Михайлович	m
Варшавский Вадим Евгеньевич	m
Шаккум Мартин Люцианович	m
Попов Александр Васильевич	m
Гоман Владимир Владимирович	m
Кобылкин Василий Федорович	m
Айздердзис Андрей Дайнисович	m
Жаров Олег Юрьевич	m
Газеев Евгений Иванович	m
Алкснис Виктор Имантович	m
Борщев Валерий Васильевич	m
Петрик Александр Григорьевич	m
Чепа Алексей Васильевич	m
Буратаева Александра Манджиевна	f
Морозов Игорь Николаевич	m
Маслюков Юрий Дмитриевич	m
Сайфуллин Франис Аскарьянович	m
Апарин Иван Васильевич	m
Соболев Анатолий Николаевич	m
Гришуков Владимир Витальевич	m
Сокол Святослав Михайлович	m
Залепухин Николай Петрович	m
Стародубец Анатолий Сергеевич	m
Валенчук Олег Дорианович	m
Зуев Алексей Алексеевич	m
Боженов Сергей Анатольевич	m
Лопатин Владимир Николаевич	m
Жебровский Станислав Михайлович	m
Зяблицев Евгений Геннадьевич	m
Мяки Артур Элденович	m
Ахметханов Салимхан Миннеханович	m
Никифоренко Юрий Васильевич	m
Гусарова Галина Ивановна	f
Южаков Владимир Николаевич	m
Загидуллов Марат Фаридович	m
Демченко Иван Иванович	m
Чеховская Наталья Михайловна	f
Алексеев Алексей Алексеевич	m
Хахичев Владимир Дмитриевич	m
Клименко Владимир Витальевич	m
Протопопов Владимир Васильевич	m
Бочаров Андрей Иванович	m
Колесников Олег Алексеевич	m
Сизов Александр Александрович	m
Мисник Борис Григорьевич	m
Столяров Олег Анатольевич	m
Новиков Александр Васильевич	m
Воротников Валерий Павлович	m
Астраханкина Татьяна Александровна	f
Шульга Александр Васильевич	m
Рохмистров Максим Станиславович	m
Бобырев Валентин Васильевич	m
Гришин Виктор Иванович	m
Шашурин Сергей Петрович	m
Гвоздева Светлана Николаевна	f
Рябов Николай Федорович	m
Сироткин Сергей Никанорович	m
Ближина Любовь Федоровна	f
Куваев Александр Александрович	m
Гольдштейн Ростислав Эрнстович	m
Бенов Геннадий Матвеевич	m
Кашин Борис Сергеевич	m
Старовойтов Александр Сергеевич	m
Грачёв Иван Дмитриевич	m
Генералов Сергей Владимирович	m
Сохов Владимир Казбулатович	m
Пономарев Александр Михайлович	m
Беляков Александр Семенович	m
Басов Владимир Васильевич	m
Гильмутдинов Ильдар Ирекович	m
Бузов Юрий Евгеньевич	m
Фокин Александр Иванович	m
Поцяпун Владимир Тимофеевич	m
Чикулаев Сергей Николаевич	m
Шипунов Константин Борисович	m
Иванов Евгений Викторович	m
Агаев Ваха Абуевич	m
Сихарулидзе Антон Тариэльевич	m
Юдин Владимир Иванович	m
Гуцериев Микаил Сафарбекович	m
Шайденко Надежда Анатольевна	f
Коротков Леонид Викторович	m
Воропаев Александр Иванович	m
Гамза Геннадий Ефимович	m
Рыжков Николай Иванович	m
Прокопьев Александр Сергеевич	m
Шахов Владимир Николаевич	m
Задорнов Михаил Михайлович	m
Чернышев Алексей Андреевич	m
Гальченко Валерий Владимирович	m
Курочкин Виктор Васильевич	m
Кислицын Василий Александрович	m
Владиславлев Александр Павлович	m
Гамзатова Хаписат Магомедовна	f
Кулешов Олег Степанович	m
Балалаев Вячеслав Ефимович	m
Сидякин Александр Геннадьевич	m
Костин Георгий Васильевич	m
Грызлов Борис Вячеславович	m
Чернышенко Игорь Константинович	m
Швалев Федор Михайлович	m
Воробчуков Сергей Анатольевич	m
Васильев Юрий Викторович	m
Гайсин Малик Фавзавиевич	m
Бенин Андрей Александрович	m
Хакамада Ирина Муцуовна	f
Пастухов Борис Николаевич	m
Воронин Юрий Михайлович	m
Починок Александр Петрович	m
Гимаев Рагиб Насретдинович	m
Семёнова Екатерина Юрьевна	f
Пекпеев Сергей Тимурович	m
Мединский Владимир Ростиславович	m
Заварницин Алексей Юрьевич	m
Баталина Ольга Юрьевна	f
Путилов Михаил Алексеевич	m
Габидуллин Ринат Гиндуллович	m
Бабаков Александр Михайлович	m
Лемешов Геннадий Владимирович	m
Митрофанов Алексей Валентинович	m
Губайдуллин Ринат Шайхуллович	m
Гагут Луиза Дмитриевна	f
Стрельченко Галина Ивановна	f
Василевский Иван Адамович	m
Хвоинский Леонид Адамович	m
Аксаков Анатолий Геннадьевич	m
Бобраков Алексей Евгеньевич	m
Тарачев Владимир Александрович	m
Тепляков Евгений Нодариевич	m
Иванов Виктор Петрович	m
Комоцкий Борис Олегович	m
Климов Андрей Аркадьевич	m
Якимов Виктор Васильевич	m
Оганян Оганес Арменакович	m
Зенкин Сергей Анатольевич	m
Ворогушин Виктор Анатольевич	m
Смоленский Владимир Иванович	m
Денисенко Бэла Анатольевна	f
Валеев Эрнест Абдулович	m
Григориади Владимир Стиллианович	m
Панченко Ирина Александровна	f
Апатенко Сергей Николаевич	m
Губский Николай Васильевич	m
Каретников Владимир Владимирович	m
Исаев Андрей Константинович	m
Сафронов Виталий Александрович	m
Иванов Николай Васильевич	m
Клинцевич Франц Адамович	m
Виноградов Владислав Владимирович	m
Савченко Олег Владимирович	m
Плотников Владимир Николаевич	m
Аверченко Владимир Александрович	m
Зацепина Нина Андреевна	f
Соколова Ирина Валерьевна	f
Семенов Сергей Сергеевич	m
Мусатов Михаил Иванович	m
Щерчков Сергей Владимирович	m
Колесников Владимир Ильич	m
Доронин Сергей Александрович	m
Горькова Ирина Петровна	f
Арсланова Фануза Шарафиевна	f
Салтыков Борис Георгиевич	m
Мартынов Борис Алексеевич	m
Грущак Сергей Владимирович	m
Стрельченко Сергей Георгиевич	m
Иванов Анатолий Семенович	m
Собакин Евгений Юрьевич	m
Скурихин Сергей Васильевич	m
Плетнева Тамара Васильевна	f
Видьманов Виктор Михайлович	m
Кожемякин Владимир Николаевич	m
Славный Василий Дмитриевич	m
Сухой Николай Авксентьевич	m
Томов Алексей Николаевич	m
Манаров Муса Хираманович	m
Савостьянова Валентина Борисовна	f
Быков Владимир Иванович	m
Богов Хазби Махарбекович	m
Козерадский Анатолий Александрович	m
Мавроди Сергей Пантелеевич	m
Травкин Николай Ильич	m
Панарин Николай Васильевич	m
Сентюрин Юрий Петрович	m
Калистратов Геннадий Степанович	m
Востротин Валерий Александрович	m
Ойкина Зоя Николаевна	f
Сенаторова Елена Николаевна	f
Соколов Вячеслав Константинович	m
Кругликов Александр Леонидович	m
Шестаков Василий Борисович	m
Тихомиров Валерий Викторович	m
Муравьев Артур Алексеевич	m
Кокошин Андрей Афанасьевич	m
Лихачев Василий Николаевич	m
Долгих Владимир Иванович	m
Карпович Наталья Николаевна	f
Шейнис Виктор Леонидович	m
Ярошенко Анатолий Иванович	m
Макаров Андрей Михайлович	m
Мирзоев Гасан Борисович	m
Карлов Георгий Александрович	m
Давлетова Камиля Жаудатовна	f
Абалаков Александр Николаевич	m
Сорокин Николай Евгеньевич	m
Кальметьев Марс Рахматуллович	m
Беспалов Иван Михайлович	m
Хадарцев Махарбек Хазбиевич	m
Туинов Евгений Вячеславович	m
Моисеев Борис Васильевич	m
Гришкевич Олег Петрович	m
Никонов Борис Иванович	m
Азарова Надежда Борисовна	f
Расторгуев Николай Вячеславович	m
Васильев Владимир Алексеевич	m
Федулов Александр Михайлович	m
Полуханов Андрей Анатольевич	m
Парадиз Александр Лазаревич	m
Лузин Геннадий Павлович	m
Нахушев Заурби Ахмедович	m
Степанов Владимир Алексеевич	m
Семенов Владимир Олегович	m
Явлинский Григорий Алексеевич	m
Гайдар Егор Тимурович	m
Яшин Виктор Анатольевич	m
Сенин Григорий Николаевич	m
Боровой Константин Натанович	m
Мальков Игорь Олегович	m
Котков Анатолий Степанович	m
Михайлов Александр Дмитриевич	m
Некрасов Леонид Васильевич	m
Степанков Валентин Георгиевич	m
Нуйкин Андрей Александрович	m
Горячев Валерий Сергеевич	m
Ковалев Василий Николаевич	m
Сирота Михаил Макарович	m
Соколов Юрий Васильевич	m
Гусаков Дмитрий Вячеславович	m
Селиверстова Ольга Юрьевна	f
Седов Юрий Дмитриевич	m
Свистунов Аркадий Николаевич	m
Лахова Екатерина Филипповна	f
Чуев Александр Викторович	m
Хмыров Василий Ильич	m
Бурбулис Геннадий Эдуардович	m
Арефьев Николай Васильевич	m
Курдюмов Александр Борисович	m
Пономарев Сергей Александрович	m
Топорков Владимир Федорович	m
Харитонов Николай Михайлович	m
Максимова Надежда Сергеевна	f
Ерёмин Дмитрий Владимирович	m
Тюлькин Виктор Аркадьевич	m
Гребенюк Владимир Дмитриевич	m
Гербер Алла Ефремовна	f
Левченко Сергей Георгиевич	m
Володин Вячеслав Викторович	m
Афанасьев Сергей Николаевич	m
Захаров Алексей Константинович	m
Качкаев Павел Рюрикович	m
Зюганов Геннадий Андреевич	m
Попов Сергей Борисович	m
Звягин Алексей Алексеевич	m
Новицкая Ирина Ефимовна	f
Семенов Павел Владимирович	m
Головлев Владимир Иванович	m
Муравленко Сергей Викторович	m
Геккиев Заур Далхатович	m
Зайцев Константин Борисович	m
Лемешев Михаил Яковлевич	m
Дегтярев Михаил Владимирович	m
Чайка Валентин Васильевич	m
Макаров Николай Иванович	m
Ждакаев Иван Андреевич	m
Босхолов Сергей Семенович	m
Костюткин Владимир Михайлович	m
Крутова Валентина Васильевна	f
Лоторев Александр Николаевич	m
Кармазина Раиса Васильевна	f
Татарчук Валентин Иванович	m
Богданова Елена Михайловна	f
Морозов Анатолий Тимофеевич	m
Фурман Александр Борисович	m
Белоусов Александр Николаевич	m
Комаров Фоат Фагимович	m
Харченко Иван Николаевич	m
Панина Елена Владимировна	f
Карабасов Юрий Сергеевич	m
Половников Станислав Петрович	m
Золотилин Сергей Александрович	m
Сайфуллин Инсаф Шарифуллович	m
Мирсаев Рамиль Нурыевич	m
Пахолков Олег Владимирович	m
Аброськин Николай Павлович	m
Бурыкина Наталья Викторовна	f
Ройзман Евгений Вадимович	m
Чурилов Алексей Викторович	m
Севенард Юрий Константинович	m
Гуськов Юрий Александрович	m
Пискун Николай Леонидович	m
Разворотнев Николай Васильевич	m
Свечников Петр Григорьевич	m
Тычинин Андрей Джафарович	m
Кауфман Юрий Алексеевич	m
Гузанов Алексей Анатольевич	m
Шибалкин Александр Степанович	m
Ермакова Наталья Афанасьевна	f
Надеждин Борис Борисович	m
Лодкин Юрий Евгеньевич	m
Харитонов Александр Николаевич	m
Медведев Николай Павлович	m
Лобов Сергей Сергеевич	m
Исаев Михаил Александрович	m
Савенко Юрий Алексеевич	m
Меденцов Геннадий Александрович	m
Кульбака Нина Ивановна	f
Зотов Игорь Львович	m
Саркисян Аркадий Рафикович	m
Гаманенко Александр Иванович	m
Дубов Владимир Матвеевич	m
Квитка Иван Иванович	m
Рохлин Лев Яковлевич	m
Финько Олег Александрович	m
Логинов Евгений Юрьевич	m
Музыкаев Аднан Абдулаевич	m
Иванов Валентин Борисович	m
Селиванов Андрей Владимирович	m
Шуба Виталий Борисович	m
Корендясев Анатолий Александрович	m
Пономарёв Алексей Алексеевич	m
Волчек Денис Геннадьевич	m
Спиридонов Юрий Алексеевич	m
Горбачев Владимир Лукич	m
Овченков Вячеслав Иванович	m
Фабричный Сергей Юрьевич	m
Елисеев Александр Игоревич	m
Кибирев Борис Григорьевич	m
Воронов Сергей Васильевич	m
Столяров Николай Сергеевич	m
Трушников Александр Христофорович	m
Яковенко Игорь Александрович	m
Нигматулин Роберт Искандрович	m
Кульмухаметов Энгельс Варисович	m
Бауэр Владимир Анатольевич	m
Михайлов Алексей Юрьевич	m
Голованов Дмитрий Сергеевич	m
Гундарева Наталья Георгиевна	f
Леонтьев Георгий Карпеевич	m
Мещерин Иван Васильевич	m
Чуркин Сергей Александрович	m
Миронов Виктор Пименович	m
Лысенко Николай Николаевич	m
Цветова Любовь Михайловна	f
Рязанов Александр Николаевич	m
Филимонов Вадим Донатович	m
Пантелеев Ардальен Иванович	m
Хулхачиев Бембя Викторович	m
Федоткин Владимир Николаевич	m
Назарова Марина Юрьевна	f
Калашников Леонид Иванович	m
Вишняков Виктор Григорьевич	m
Четвериков Александр Владимирович	m
Тетекин Вячеслав Николаевич	m
Купцов Валентин Александрович	m
Жарков Антон Викторович	m
Баюнов Владимир Александрович	m
Колесников Виктор Иванович	m
Моисеев Борис Александрович	m
Бабух Лариса Владимировна	f
Федоров Борис Григорьевич	m
Свинцов Андрей Николаевич	m
Сафаралиев Гаджимет Керимович	m
Черногоров Александр Леонидович	m
Прощин Сергей Александрович	m
Кашпировский Анатолий Михайлович	m
Лысяков Алексей Алексеевич	m
Митрофанова Элеонора Валентиновна	f
Вороненков Денис Николаевич	m
Игошин Игорь Николаевич	m
Будажапов Сергей Пурбуевич	m
Етылин Владимир Михайлович	m
Пекарев Владимир Янович	m
Моисеев Анатолий Семенович	m
Сарычев Алексей Николаевич	m
Аулов Александр Петрович	m
Дайхес Николай Аркадьевич	m
Барлыбаев Халиль Абубакирович	m
Кидяев Виктор Борисович	m
Лотков Виктор Николаевич	m
Вервейко Надежда Алексеевна	f
Симановский Леонид Яковлевич	m
Жамсуев Баир Баясхаланович	m
Лабейкин Александр Алексеевич	m
Казаков Виктор Алексеевич	m
Янковский Аркадий Эдуардович	m
Шудегов Виктор Евграфович	m
Нарочницкая Наталия Алексеевна	f
Гончаров Виктор Иванович	m
Песковская Юлия Анатольевна	f
Филатов Александр Валентинович	m
Нестеренко Валерий Иванович	m
Саввиди Иван Игнатьевич	m
Дорохин Павел Сергеевич	m
Останина Нина Александровна	f
Муслимов Ильяз Булатович	m
Султанов Ринат Ишбулдович	m
Кравцов Владимир Иванович	m
Мусатов Иван Михайлович	m
Исмагилов Рашид Фаатович	m
Савицкий Олег Владимирович	m
Черешнев Валерий Александрович	m
Бученков Евгений Викторович	m
Агафонов Егор Андреевич	m
Мартынов Александр Гаврилович	m
Бугера Михаил Евгеньевич	m
Опёнышев Сергей Павлович	m
Паутов Виктор Николаевич	m
Катальников Владимир Дмитриевич	m
Пепеляева Лиана Витальевна	f
Напсо Юрий Аисович	m
Ольшанский Николай Михайлович	m
Рубежанский Петр Николаевич	m
Денин Николай Васильевич	m
Веселкин Павел Михайлович	m
Минаков Виктор Михайлович	m
Якунин Глеб Павлович	m
Сарычев Александр Викторович	m
Скоробогатько Александр Иванович	m
Подуфалов Николай Дмитриевич	m
Запольский Сергей Васильевич	m
Локоть Анатолий Евгеньевич	m
Костерин Николай Николаевич	m
Гаюльский Виктор Иванович	m
Очирова Александра Васильевна	f
Киселев Вячеслав Викторович	m
Петров Александр Петрович	m
Тягунов Александр Александрович	m
Цветков Валентин Иванович	m
Гуляев Руслан Александрович	m
Калмыков Юрий Хамзатович	m
Сапожников Николай Иванович	m
Руденский Игорь Николаевич	m
Уткин Юрий Васильевич	m
Воробьев Эдуард Аркадьевич	m
Фадзаев Арсен Сулейманович	m
Броницын Андрей Юрьевич	m
Горячев Марк Леонидович	m
Дегтярев Александр Николаевич	m
Бурулько Александр Петрович	m
Семеньков Василий Иванович	m
Боков Владимир Анатольевич	m
Ющенко Александр Андреевич	m
Скворцов Вячеслав Николаевич	m
Горячева Светлана Петровна	f
Заверюха Александр Харлампиевич	m
Кокорев Евгений Михайлович	m
Кошкин Михаил Петрович	m
Никитчук Иван Игнатьевич	m
Кныш Валентин Филиппович	m
Сергеенков Александр Николаевич	m
Сигарев Сергей Федорович	m
Фролов Александр Константинович	m
Коровников Александр Венидиктович	m
Савельев Николай Николаевич	m
Кузнецов Александр Владимирович	m
Лебедь Александр Иванович	m
Диденко Алексей Николаевич	m
Назарчук Александр Григорьевич	m
Мороз Василий Андреевич	m
Буткеев Владимир Анатольевич	m
Никифоров Сергей Михайлович	m
Гуров Александр Иванович	m
Трепов Евгений Александрович	m
Попов Сергей Александрович	m
Ивлев Иван Алексеевич	m
Давыдов Александр Семенович	m
Найчукова Светлана Ивановна	f
Брагинский Александр Павлович	m
Репкин Виктор Павлович	m
Денисов Олег Иванович	m
Ген Николай Леонидович	m
Мещерякова Татьяна Григорьевна	f
Петров Сергей Валериевич	m
Шишкарев Сергей Николаевич	m
Маркин Андрей Леонидович	m
Гудков Геннадий Владимирович	m
Брынцалов Владимир Алексеевич	m
Казарин Виктор Николаевич	m
Злобин Владимир Вениаминович	m
Савельев Константин Сергеевич	m
Никитин Владимир Петрович	m
Геращенко Виктор Владимирович	m
Багдасаров Семен Аркадьевич	m
Арбатов Алексей Георгиевич	m
Прокопенко Тимур Валентинович	m
Озеров Андрей Александрович	m
Жукова Нелля Николаевна	f
Шеин Анатолий Алексеевич	m
Крашенинников Павел Владимирович	m
Сагитов Ринат Шайхимансурович	m
Кулиева Василина Васильевна	f
Леонов Николай Сергеевич	m
Бурносов Александр Леонидович	m
Шичанин Игорь Александрович	m
Москвичев Евгений Сергеевич	m
Омаров Гаджимурад Заирбекович	m
Оленьев Вячеслав Владимирович	m
Егоров Геннадий Васильевич	m
Бурматов Владимир Владимирович	m
Поддубный Сергей Анатольевич	m
Новикова Клавдия Николаевна	f
Григорьев Владимир Федорович	m
Артемьев Анатолий Иванович	m
Кондратенко Николай Игнатович	m
Доровин Евгений Владимирович	m
Габдрахманов Ильдар Нуруллович	m
Киселев Николай Петрович	m
Баринов Игорь Вячеславович	m
Малкин Евгений Борисович	m
Савчук Вера Семеновна	f
Семигин Геннадий Юрьевич	m
Черемушкин Василий Павлович	m
Давиденко Владимир Иванович	m
Карапетян Саак Альбертович	m
Альмяшкин Василий Петрович	m
Лебедева Марина Яковлевна	f
Чепасова Тамара Эдуардовна	f
Турбанов Александр Владимирович	m
Брусникин Николай Юрьевич	m
Медведев Павел Алексеевич	m
Белоусов Вадим Владимирович	m
Глубоковский Михаил Константинович	m
Лепехин Владимир Анатольевич	m
Русских Алексей Юрьевич	m
Леончев Владимир Александрович	m
Ильковский Константин Константинович	m
Севастьянов Виталий Иванович	m
Сеславинский Михаил Вадимович	m
Аршба Отари Ионович	m
Баскаев Аркадий Георгиевич	m
Кабаева Алина Маратовна	f
Махмудов Махмуд Гаджулаевич	m
Гонжаров Олег Павлович	m
Федулова Алевтина Васильевна	f
Романов Валентин Степанович	m
Темиржанов Владимир Хасанбиевич	m
Бойко Вадим Анатольевич	m
Дорофеев Сергей Борисович	m
Титенко Борис Михайлович	m
Жигарев Сергей Александрович	m
Гребенкин Олег Анатольевич	m
Давыдкин Виктор Алексеевич	m
Левичев Николай Владимирович	m
Тихонов Руслан Кронидович	m
Швыряев Ярослав Михайлович	m
Рогонов Петр Петрович	m
Иваненко Сергей Викторович	m
Манякин Сергей Иосифович	m
Осовцов Александр Авраамович	m
Вайнштейн Сергей Евгеньевич	m
Генералов Андрей Иванович	m
Примаков Евгений Максимович	m
Алтухов Владимир Николаевич	m
Тимченко Вячеслав Степанович	m
Алексеев Геннадий Алексеевич	m
Комоедов Владимир Петрович	m
Корниенко Алексей Викторович	m
Семенченко Анатолий Федорович	m
Махачев Гаджи Нухиевич	m
Шоршоров Степан Мкртычевич	m
Васильев Максим Игоревич	m
Игнатова Марина Валерьевна	f
Бондарь Вадим Николаевич	m
Алимова Ольга Николаевна	f
Бердов Геннадий Ильич	m
Дмитриева Оксана Генриховна	f
Муравьев Игорь Владиславович	m
Гришанков Михаил Игнатьевич	m
Устинов Игорь Гаврилович	m
Жолобов Олег Владимирович	m
Климантова Галина Ивановна	f
Берестовой Виктор Иванович	m
Чистоходова Рита Васильевна	f
Бушмин Евгений Викторович	m
Дружинин Геннадий Иннокентьевич	m
Берестов Александр Павлович	m
Мамаев Сергей Павлинович	m
Миронов Сергей Михайлович	m
Баталова Рима Акбердиновна	f
Нефедов Виктор Леонидович	m
Чершинцев Александр Григорьевич	m
Антонов Виктор Васильевич	m
Ресин Владимир Иосифович	m
Молоствов Михаил Михайлович	m
Курьянович Николай Владимирович	m
Назаров Андрей Геннадьевич	m
Учитель Виктор Александрович	m
Чикин Валентин Васильевич	m
Журавлев Алексей Александрович	m
Максакова-Игенбергс Мария Петровна	f
Горбачев Владимир Иванович	m
Куликов Анатолий Сергеевич	m
Павлов Николай Александрович	m
Абрамович Роман Аркадиевич	m
Голушко Андрей Иванович	m
Бакиев Рим Сагитович	m
Головнёв Владимир Александрович	m
Липатов Юрий Александрович	m
Самошин Андрей Анатольевич	m
Митин Сергей Герасимович	m
Яхихажиев Саид Кожалович	m
Медиков Виктор Яковлевич	m
Попов Сергей Анатольевич	m
Богомолов Олег Тимофеевич	m
Лосский Юрий Васильевич	m
Лукьянов Анатолий Иванович	m
Голубков Анатолий Иванович	m
Шарапов Владимир Федорович	m
Агеев Александр Александрович	m
Крутов Александр Николаевич	m
Усачев Виктор Васильевич	m
Василишин Алексей Викторович	m
Михайлов Валентин Вахтангович	m
Григорьев Сергей Михайлович	m
Бессарабов Владимир Григорьевич	m
Ющенко Анатолий Александрович	m
Гуков Виталий Владимирович	m
Попов Сергей Алексеевич	m
Яркин Лев Николаевич	m
Скорлуков Олег Альбертович	m
Гаджиев Магомед Тажудинович	m
Игрунов Вячеслав Владимирович	m
Коган Александр Борисович	m
Ремчуков Константин Вадимович	m
Уварова Ольга Евгеньевна	f
Пожигайло Павел Анатольевич	m
Бобровская Ольга Владимировна	f
Широков Сергей Валентинович	m
Салий Александр Иванович	m
Свиридов Валентин Валентинович	m
Елизаров Илья Елизарович	m
Машинский Виктор Леонидович	m
Ильтяков Александр Владимирович	m
Поляков Николай Иванович	m
Кузнецов Вячеслав Юрьевич	m
Пимашков Петр Иванович	m
Гостев Руслан Георгиевич	m
Кобелев Виктор Васильевич	m
Десятников Василий Алексеевич	m
Филиппов Александр Николаевич	m
Железняк Сергей Владимирович	m
Колесник Андрей Иванович	m
Денисов Валентин Петрович	m
Митина Дарья Александровна	f
Балашов Балаш Курбанмагомедович	m
Туманов Владимир Александрович	m
Турусин Анатолий Афанасьевич	m
Гудима Тамара Михайловна	f
Задонский Георгий Иванович	m
Черкесов Виктор Васильевич	m
Певцов Владимир Андреевич	m
Янаков Эдуард Якимович	m
Панина Бэлла Леонидовна	f
Костунов Илья Евгеньевич	m
Афонский Владимир Игорьевич	m
Вакуленко Михаил Юрьевич	m
Бокова Людмила Николаевна	f
Багаутдинов Габдулвахит Гильмутдинович	m
Смоляков Владимир Николаевич	m
Зеленов Евгений Алексеевич	m
Зорин Владимир Юрьевич	m
Старшинов Михаил Евгеньевич	m
Шенкарев Олег Александрович	m
Борисовец Юрий Львович	m
Долгополов Анатолий Александрович	m
Захарьящев Василий Иванович	m
Шурчанов Валентин Сергеевич	m
Курин Юрий Геннадьевич	m
Савицкий Виталий Викторович	m
Агаев Бекхан Вахаевич 	m
Горячева Раиса Вениаминовна	f
Лазарев Георгий Геннадьевич	m
Бирюков Анатолий Михайлович	m
Никонов Вячеслав Алексеевич	m
Мусалимов Николай Николаевич	m
Биндюков Николай Гаврилович	m
Ищенко Александр Николаевич	m
Ельцов Виктор Николаевич	m
Страхов Алексей Леонидович	m
Зубицкий Борис Давыдович	m
Бурдуков Павел Тимофеевич	m
Гудков Дмитрий Геннадьевич	m
Богомолов Валерий Николаевич	m
Беднов Александр Викторович	m
Жуков Александр Дмитриевич	m
Галазий Григорий Иванович	m
Немцов Борис Ефимович	m
Максимова Светлана Викторовна	f
Зеренков Валерий Георгиевич	m
Марченко Евгений Владимирович	m
Стрельников Александр Николаевич	m
Камышинский Николай Акимович	m
Ахметов Спартак Галеевич	m
Корнилова Зоя Афанасьевна	f
Рудикова Любовь Михайловна	f
Островский Алексей Владимирович	m
Щекочихин Юрий Петрович	m
Боос Георгий Валентинович	m
Третьяк Владислав Александрович	m
Иванченко Леонид Андреевич	m
Баков Антон Алексеевич	m
Колесников Виктор Михайлович	m
Зеленкин Виктор Васильевич	m
Сигуткин Алексей Алексеевич	m
Иконников Василий Николаевич	m
Медведев Юрий Германович	m
Головков Алексей Леонардович	m
Котляр Валентин Алексеевич	m
Егоров Сергей Николаевич	m
Шандыбин Василий Иванович	m
Швецов Василий Георгиевич	m
Лунцевич Валентин Васильевич	m
Чуприна Николай Нестерович	m
Бородай Виктор Иванович	m
Мельков Алексей Константинович	m
Ивер Василий Михайлович	m
Гималетдинов Ильдар Мансурович	m
Ковалев Сергей Адамович	m
Крылов Василий Стефанович	m
Салихов Хафиз Миргазямович	m
Яковлева Лариса Николаевна	f
Банщиков Михаил Константинович	m
Динес Игорь Юрьевич	m
Малахаткина Наталья Дмитриевна	f
Стародубцев Василий Александрович	m
Саралиев Шамсаил Юнусович	m
Искужин Рамиль Кабирович	m
Плохотнюк Борис Владимирович	m
Застрожная Ольга Кирилловна	f
Аракчаа Кара-Кыс Донгаковна	f
Дорогин Валерий Федорович	m
Пирожникова Людмила Владимировна	f
Рожков Виктор Дмитриевич	m
Ковалев Валентин Алексеевич	m
Веретено Александр Константинович	m
Нестеров Юрий Михайлович	m
Коваленко Павел Иванович	m
Леушкин Алексей Иванович	m
Кривоносов Сергей Владимирович	m
Чуканов Николай Александрович	m
Есяков Сергей Яковлевич	m
Тарасенко Михаил Васильевич	m
Николаев Андрей Иванович	m
Коваль Александр Павлович	m
Житинкин Сергей Владимирович	m
Бабичев Игорь Викторович	m
Матяшов Петр Иванович	m
Брячак Михаил Васильевич	m
Ханкоев Игорь Матвеевич	m
Комиссаров Валерий Яковлевич	m
Варенников Валентин Иванович	m
Тен Юрий Михайлович	m
Ткачев Александр Николаевич	m
Агафонов Валентин Алексеевич	m
Плигин Владимир Николаевич	m
Когогина Альфия Гумаровна	f
Кирий Петр Яковлевич	m
Михеев Олег Леонидович	m
Айпин Еремей Данилович	m
Таранин Виктор Иванович	m
Устинов Виктор Иванович	m
Рыков Константин Игоревич	m
Кувшинов Александр Иванович	m
Коргунов Олег Николаевич	m
Ишмуратова Светлана Ирековна	f
Федоров Николай Васильевич	m
Мельников Алексей Юрьевич	m
Рагозин Кирилл Иосифович	m
Дятленко Валерий Владимирович	m
Пятчиц Николай Митрофанович	m
Шаврин Сергей Иванович	m
Каримова Дания Юсуфовна	f
Швецов Александр Сергеевич	m
Жуковский Александр Иванович	m
Красов Андрей Леонидович	m
Заславский Илья Иосифович	m
Гончаров Николай Николаевич	m
Муцоев Зелимхан Аликоевич	m
Зубалев Владимир Степанович	m
Герасименко Николай Федорович	m
Мащенко Олег Иванович	m
Томчин Григорий Алексеевич	m
Петров Сергей Анатольевич	m
Богуславский Ирек Борисович	m
Умаханов Умахан Магомедгаджиевич	m
Карелин Александр Александрович	m
Нарусова Людмила Борисовна	f
Конев Юрий Михайлович	m
Журавлев Сергей Валерианович	m
Салчак Галина Алексеевна	f
Глубоковская Эльмира Гусейновна	f
Зотиков Алексей Алексеевич	m
Панченко Любовь Анатольевна	f
Илюхин Виктор Иванович	m
Зоркальцев Виктор Ильич	m
Каноков Арсен Баширович	m
Озеров Сергей Павлович	m
Трапезников Валерий Владимирович	m
Паршенцева Галина Васильевна	f
Сафин Марат Мубинович	m
Третяк Борис Никитович	m
Южилин Виталий Александрович	m
Зуев Константин Эдуардович	m
Котов Николай Савельевич	m
Васильев Владимир Абдуалиевич	m
Кадочников Владимир Дмитриевич	m
Усольцев Василий Иванович	m
Титов Герман Степанович	m
Рульков Евгений Адамович	m
Петухова Наталья Рэмовна	f
Мартынова Валентина Григорьевна	f
Никитин Анатолий Алексеевич	m
Бабурин Сергей Николаевич	m
Максаков Александр Иванович	m
Апарина Алевтина Викторовна	f
Хоркина Светлана Васильевна	f
Фильшин Михаил Владимирович	m
Пчелкин Владимир Викторович	m
Коломейцев Виктор Андреевич	m
Губкин Анатолий Алексеевич	m
Дубровин Вячеслав Анатольевич	m
Кузнецов Виктор Егорович	m
Глотов Сергей Александрович	m
Тян Любомир Индекович	m
Ромашкин Виктор Васильевич	m
Климов Виктор Владимирович	m
Чернявский Валентин Семёнович	m
Шульгин Сергей Николаевич	m
Обухов Сергей Павлович	m
Ананских Игорь Александрович	m
Хакимов Мидхат Гайнанович	m
Дурягин Иван Николаевич	m
Вяткин Дмитрий Федорович	m
Старков Анатолий Михайлович	m
Вахаев Хож Магомед Хумайдович	m
Гайдаш Мария Ивановна	f
Старовойтова Галина Васильевна	f
Кириенко Сергей Владиленович	m
Гусаров Евгений Александрович	m
Воронин Павел Юрьевич	m
Николаев Михаил Ефимович	m
Полторанин Михаил Никифорович	m
Булавинов Вадим Евгеньевич	m
Волкова Нина Вениаминовна	f
Антонов Роман Валерьевич	m
Тумусов Федот Семёнович	m
Цику Казбек Асланбечевич	m
Власова Анна Петровна	f
Корсаков Николай Николаевич	m
Зиятдинова Флюра Газизовна	f
Шевелуха Виктор Степанович	m
Егиазарян Ашот Геворкович	m
Веер Артур Павлович	m
Зубов Валерий Михайлович	m
Севенард Константин Юрьевич	m
Фахритдинов Иршат Юнирович	m
Чиркин Андрей Борисович	m
Шабанов Александр Александрович	m
Амирханов Алихан Хусейнович	m
Волковский Василий Иванович	m
Поневежский Владимир Александрович	m
Хаджебиеков Руслан Гиссович	m
Берхеев Ильдар Мансурович	m
Харлов Вадим Борисович	m
Красницкий Евгений Сергеевич	m
Неверов Сергей Иванович	m
Азизов Магомедфазил Загидинович	m
Соколов Александр Сергеевич	m
Михайлов Александр Николаевич	m
Смирнова Светлана Константиновна	f
Клочков Игорь Евгеньевич	m
Коган Юрий Владимирович	m
Литвинов Владимир Александрович	m
Сивиркин Дмитрий Вадимович	m
Курбанов Ризван Даниялович	m
Хамитов Эдуард Шайхуллович	m
Кулик Геннадий Васильевич	m
Синельщиков Юрий Петрович	m
Жидких Владимир Александрович	m
Солдаткин Дмитрий Федорович	m
Давыдов Всеволод Геннадьевич	m
Шевченко Вячеслав Алексеевич	m
Селиванов Юрий Алексеевич	m
Рыгалов Александр Андреевич	m
Суренков Владимир Сидорович	m
Кнышов Алексей Владимирович	m
Пащенко Эдуард Александрович	m
Липицкий Василий Семенович	m
Иванов Михаил Петрович	m
Завальный Павел Николаевич	m
Сысоев Александр Митрофанович	m
Зиновьев Василий Васильевич	m
Корниенко Виктор Ульянович	m
Дорошенко Галина Степановна	f
Рогозин Дмитрий Олегович	m
Коршунов Лев Александрович	m
Баржанова Маргарита Валерьевна	f
Терентьев Александр Васильевич	m
Гдлян Тельман Хоренович	m
Шевцов Георгий Егорович	m
Панин Виктор Евгеньевич	m
Тишковская Евгения Леонидовна	f
Мазур Александр Алексеевич	m
Шхагошев Адальби Люлевич	m
Зволинский Вячеслав Петрович	m
Худяков Иван Дмитриевич	m
Бифов Анатолий Жамалович	m
Ботка Николай Петрович	m
Хамчиев Белан Багаудинович	m
Елисейкин Станислав Агафонович	m
Мартемьянов Валентин Семенович	m
Тарасов Артем Михайлович	m
Аюпов Мансур Анварович	m
Стальмахов Владимир Александрович	m
Майтаков Георгий Григорьевич	m
Лунтовский Георгий Иванович	m
Василенко Александр Борисович	m
Станкевич Сергей Борисович	m
Салихов Альберт Ильдусович	m
Литвинов Николай Петрович	m
Токарева Тамара Петровна	f
Герасимова Надежда Васильевна	f
Николаева Елена Леонидовна	f
Ларицкий Владимир Ермолаевич	m
Туголуков Евгений Александрович	m
Меркулов Александр Федорович	m
Булгакова Татьяна Ивановна	f
Анохин Павел Викторович	m
Иванов Сергей Владимирович	m
Езерский Николай Николаевич	m
Трофимов Евгений Николаевич	m
Потомский Вадим Владимирович	m
Бурлуцкий Юрий Иванович	m
Завгаев Ахмар Гапурович	m
Юревич Михаил Валериевич	m
Зелинский Ян Викторович	m
Свердлов Юрий Владимирович	m
Скорочкин Сергей Григорьевич	m
Загидуллин Сергей Ильгизович	m
Зубакин Семен Иванович	m
Мухаметзакиров Анвар Мухаметкадырович	m
Завадская Людмила Николаевна	f
Федоткин Иван Тимофеевич	m
Аслаханов Асламбек Ахмедович	m
Резник Владислав Матусович	m
Рязанский Валерий Владимирович	m
Черторицкая Татьяна Владимировна	f
Дон Сергей Эдуардович	m
Кузьминых Тамара Гавриловна	f
Звагельский Виктор Фридрихович	m
Митяев Иван Иванович	m
Пашенных Феликс Семенович	m
Рожков Игорь Анатольевич	m
Кондакова Елена Владимировна	f
Богатов Владимир Владимирович	m
Столярова Насима Калимовна	f
Таланов Виктор Львович	m
Казаков Борис Анушеванович	m
Балберов Александр Александрович	m
Морозов Олег Викторович	m
Беляев Сергей Георгиевич	m
Казаров Олег Владимирович	m
Каргинов Сергей Генрихович	m
Карелова Галина Николаевна	f
Скруг Валерий Степанович	m
Капков Сергей Александрович	m
Рожкова Любовь Петровна	f
Язев Валерий Афонасьевич	m
Радзиховский Леонид Александрович	m
Мурзабаева Салия Шарифьяновна	f
Минжуренко Александр Васильевич	m
Керимов Сулейман Абусаидович	m
Осипов Вячеслав Константинович	m
Костерин Евгений Алексеевич	m
Амиров Курбан-Али Амирович	m
Антуфьев Сергей Владимирович	m
Волчек Галина Борисовна	f
Фоменко Александр Владимирович	m
Гусенков Владимир Петрович	m
Алексеева Татьяна Олеговна	f
Гуськов Анатолий Владимирович	m
Воробьев Андрей Юрьевич	m
Злотникова Тамара Владимировна	f
Бабошкин Анатолий Васильевич	m
Тетельмин Владимир Владимирович	m
Руда Юрий Михайлович	m
Резник Борис Львович	m
Бегов Омар Омарович	m
Цыбакин Юрий Владимирович	m
Кривельская Нина Викторовна	f
Рыбкин Иван Петрович	m
Камшилов Петр Петрович	m
Шпак Георгий Иванович	m
Слуцкий Леонид Эдуардович	m
Степанова Зоя Михайловна	f
Безбородов Николай Максимович	m
Лозинская Жанна Михайловна	f
Ондар Чылгычы Чимит-Доржуевич	m
Калягин Владимир Александрович	m
Черномырдин Виктор Степанович	m
Маркидонов Сергей Александрович	m
Василев Владимир Александрович	m
Кононов Владимир Михайлович	m
Волков Геннадий Константинович	m
Шлегель Роберт Александрович	m
Михайлов Евгений Эдуардович	m
Гордеев Анатолий Николаевич	m
Шадаев Дамир Равильевич	m
Чубкова Галина Петровна	f
Яковлев Юрий Николаевич	m
Баранников Александр Евгеньевич	m
Бабичев Владимир Степанович	m
Жилина Антонина Александровна	f
Малашенко Виктор Александрович	m
Галичанин Евгений Николаевич	m
Гальцова Ольга Дмитриевна	f
Карпов Анатолий Евгеньевич	m
Жук Эдвард Георгиевич	m
Косариков Александр Николаевич	m
Попов Анатолий Геннадьевич	m
Зырянов Павел Александрович	m
Самиев Ильдар Рафикович	m
Артемьев Игорь Юрьевич	m
Иткулов Салават Гильмишарифович	m
Лихачев Алексей Евгеньевич	m
Пузановский Адриан Георгиевич	m
Шубина Любовь Федоровна	f
Сайфуллин Альзам Тухватуллинович	m
Кузьмичева Екатерина Ивановна	f
Галиев Ахметгали Мухаметгалиевич	m
Мануйлова Ирина Викторовна	f
Игнатов Владислав Михайлович	m
Гужвин Петр Анатольевич	m
Иванова Валентина Николаевна	f
Кушнарь Александр Леонидович	m
Нилов Олег Анатольевич	m
Чубайс Анатолий Борисович	m
Шишлов Александр Владимирович	m
Грицань Владимир Васильевич	m
Глазьев Сергей Юрьевич	m
Анненский Игорь Александрович	m
Поморов Александр Адрианович	m
Гончар Николай Николаевич	m
Сидоров Михаил Николаевич	m
Галкин Александр Александрович	m
Амирилаев Адам Баширович	m
Лапшина Елена Николаевна	f
Ширшов Константин Владимирович	m
Тайсаев Казбек Куцукович	m
Сидоров Евгений Юрьевич	m
Дедов Виктор Михайлович	m
Сутягинский Михаил Александрович	m
Аскерханов Гамид Рашидович	m
Пешков Виктор Петрович	m
Хангельдыев Борис Байлиевич	m
Кожевникова Мария Александровна	f
Шитуев Валерий Анатольевич	m
Шакиров Рифхат Мидхатович	m
Никитин Валерий Александрович	m
Мухина Елена Юрьевна	f
Семёнов Владимир Владиславович	m
Лысаков Вячеслав Иванович	m
Лукава Георгий Григорьевич	m
Субботин Константин Сергеевич	m
Канаев Леонид Михайлович	m
Стариков Иван Валентинович	m
Ковалев Николай Дмитриевич	m
Кашин Владимир Иванович	m
Леднев Валентин Петрович	m
Каминский Александр Викторович	m
Сабадаш Алексей Владиславович	m
Гутенев Владимир Владимирович	m
Абрамов Иван Николаевич	m
Юрчик Владислав Григорьевич	m
Горюнов Владимир Дмитриевич	m
Коньков Дмитрий Сергеевич	m
Чиндяскин Сергей Викторович	m
Сидоров Анатолий Степанович	m
Подмаско Валерий Борисович	m
Балыхин Григорий Артёмович	m
Груздев Владимир Сергеевич	m
Пинский Виктор Витальевич	m
Лекарева Вера Александровна	f
Еньков Сергей Алексеевич	m
Позгалев Вячеслав Евгеньевич	m
Мокрый Владимир Семенович	m
Ермолин Анатолий Александрович	m
Кармоков Хачим Мухамедович	m
Панферов Константин Николаевич	m
Фролов Владимир Афанасьевич	m
Гусев Владимир Кузьмич	m
Лигачев Егор Кузьмич	m
Левин Леонид Леонидович	m
Розенбаум Александр Яковлевич	m
Камалетдинов Венер Хаернасович	m
Мальчихин Валерий Андреевич	m
Быстров Сергей Николаевич	m
Траспов Александр Михайлович	m
Виноградов Борис Алексеевич	m
Куликов Олег Анатольевич	m
Кабанова Валентина Викторовна	f
Осадчий Сергей Юрьевич	m
Бенедиктов Николай Анатольевич	m
Касьянов Игорь Николаевич	m
Лапшин Михаил Иванович	m
Квицинский Юлий Александрович	m
Хайров Ринат Шамильевич	m
Афанасьев Александр Михайлович	m
Кравец Александр Алексеевич	m
Капустин Анатолий Владимирович	m
Макашов Альберт Михайлович	m
Жириновский Владимир Вольфович	m
Райков Геннадий Иванович	m
Сурков Михаил Семенович	m
Маринин Сергей Владимирович	m
Калюжный Руслан Валерьевич	m
Воронцов Николай Николаевич	m
Винидиктов Александр Николаевич	m
Борзюк Владимир Михайлович	m
Гартунг Валерий Карлович	m
Аникеев Григорий Викторович	m
Кармеев Анбяр Арифуллович	m
Ефимов Виталий Борисович	m
Войтенко Виктор Петрович	m
Васильев Александр Николаевич	m
Швец Любовь Никитична	f
Яшин Александр Михайлович	m
Мучаев Иван Камуевич	m
Пивненко Валентина Николаевна	f
Панов Валерий Викторович	m
Басыгысов Виталий Николаевич	m
Школкина Надежда Васильевна	f
Сироткин Владимир Дмитриевич	m
Тихонов Георгий Иванович	m
Кузнецов Борис Юрьевич	m
Чепурных Елена Евгеньевна	f
Малышак Юрий Геннадиевич	m
Савицкая Светлана Евгеньевна	f
Корнеева Надежда Анатольевна	f
Адамишин Анатолий Леонидович	m
Говорухин Станислав Сергеевич	m
Давитиашвили Денис Александрович	m
Кравченко Валерий Николаевич	m
Головатюк Андрей Михайлович	m
Афонин Юрий Вячеславович	m
Толстопятов Василий Васильевич	m
Лисиненко Игорь Васильевич	m
Жуков Андрей Дмитриевич	m
Текеев Магомет Абдул-Халимович	m
Данилов-Данильян Виктор Иванович	m
Мельников Иван Иванович	m
Чухин Иван Иванович	m
Лета Тамара Ильинична	f
Кропачев Александр Сергеевич	m
Хачилаев Надиршах Мугадович	m
Хованская Галина Петровна	f
Невзоров Александр Глебович	m
Махмутов Анвар Анасович	m
Цой Валентин Евгеньевич	m
Вершинин Василий Федорович	m
Черкасов Кирилл Игоревич	m
Ходырев Геннадий Максимович	m
Громов Владимир Павлович	m
Климов Владимир Владимирович	m
Малахов Михаил Георгиевич	m
Очин Олег Федорович	m
Бортко Владимир Владимирович	m
Сумин Петр Иванович	m
Мишустина Лариса Павловна	f
Штогрин Сергей Иванович	m
Шпорт Вячеслав Иванович	m
Лайкам Константин Эмильевич	m
Шохин Сергей Олегович	m
Ниязов Абдул-Вахед Валидович	m
Большаков Евгений Александрович	m
Заяшников Евгений Николаевич	m
Алтухов Василий Петрович	m
Огородова Людмила Михайловна	f
Дроздов Илья Юрьевич	m
Плескачевский Виктор Семенович	m
Белова Ирина Олеговна	f
Епифанова Ольга Николаевна	f
Маркелов Михаил Юрьевич	m
Барышев Владимир Иванович	m
Олейник Любовь Васильевна	f
Ломакин-Румянцев Александр Вадимович	m
Авалиани Теймураз Георгиевич	m
Гладилин Валерий Павлович	m
Пузанов Игорь Евгеньевич	m
Данилов Михаил Александрович	m
Рыбаков Юлий Андреевич	m
Леонов Юрий Юрьевич	m
Наумов Олег Георгиевич	m
Шаклеин Николай Иванович	m
Заричанский Станислав Константинович	m
Сергеенков Владимир Нилович	m
Поздняков Владимир Георгиевич	m
Булаев Николай Иванович	m
Березовский Борис Абрамович	m
Замай Борис Иванович	m
Ямадаев Руслан Бекмирзаевич	m
Бикалова Надежда Александровна	f
Пронин Александр Владимирович	m
Слива Анатолий Яковлевич	m
Исаков Владимир Борисович	m
Яровая Ирина Анатольевна	f
Монастырский Михаил Львович	m
Горовой Николай Иванович	m
Овсянников Владимир Анатольевич	m
Паринов Николай Васильевич	m
Носов Дмитрий Юрьевич	m
Шостаковский Вячеслав Николаевич	m
Соловьев Вадим Георгиевич	m
Юсупов Марсель Харисович	m
Шевелев Андрей Владимирович	m
Хамаев Азат Киямович	m
Чилингаров Артур Николаевич	m
Федоров Святослав Николаевич	m
Глущенко Михаил Иванович	m
Малеев Валерий Геннадьевич	m
Шахрай Сергей Михайлович	m
Гридин Владимир Григорьевич	m
Мурашев Аркадий Николаевич	m
Шишкин Александр Геннадьевич	m
Скоч Андрей Владимирович	m
Магдеев Марат Фаикович	m
Габоев Владимир Николаевич	m
Тропин Николай Максимович	m
Орлова Надежда Павловна	f
Борцов Николай Иванович	m
Золотухин Борис Андреевич	m
Чаплинский Сергей Игоревич	m
Тотиев Сергей Александрович	m
Кретов Александр Владимирович	m
Воронцова Зоя Ивановна	f
Хинштейн Александр Евсеевич	m
Марычев Вячеслав Антонович	m
Манжосов Николай Иванович	m
Дубовик Владимир Анатольевич	m
Хесин Михаил Яковлевич	m
Лисичкин Владимир Александрович	m
Куликов Александр Дмитриевич	m
Жаданова Людмила Александровна	f
Лушин Владимир Петрович	m
Черкесова Виктория Валерьевна	f
Билалов Ахмед Гаджиевич	m
Мизулина Елена Борисовна	f
Хисматуллин Рашит Сагитович	m
Шеин Олег Васильевич	m
Котюсов Александр Николаевич	m
Чертищев Владимир Сергеевич	m
Беляков Антон Владимирович	m
Рыжак Николай Викторович	m
Свищев Дмитрий Александрович	m
Фомин Александр Анатольевич	m
Лукашев Игорь Львович	m
Пономарев Илья Владимирович	m
Шиманов Александр Алексеевич	m
Ремезков Александр Александрович	m
Смолин Олег Николаевич	m
Некрасов Александр Николаевич	m
Чекис Анатолий Владимирович	m
Гасанов Джамаладин Набиевич	m
Тарасов Валерий Михайлович	m
Тен Сергей Юрьевич	m
Гаврилов Сергей Анатольевич	m
Лыжин Юрий Васильевич	m
Сердюк Михаил Иванович	m
Мальцева Людмила Давыдовна	f
Орголайнен Александр Арович	m
Деренковский Виктор Яковлевич	m
Воронцов Анатолий Евгеньевич	m
Аристов Александр Михайлович	m
Косачев Константин Иосифович	m
Плахотников Алексей Михайлович	m
Выборнова Ирина Евгеньевна	f
Гаджиев Мурад Станиславович	m
Никитин Владимир Степанович	m
Чижов Сергей Викторович	m
Максимов Валерий Николаевич	m
Фральцова Тамара Анатольевна	f
Амелина Алла Леонидовна	f
Лебедев Олег Владимирович	m
Панков Николай Васильевич	m
Зубарев Виктор Владиславович	m
Архипов Игорь Витальевич	m
Шрейдер Виктор Филиппович	m
Бездольный Александр Васильевич	m
Кочиев Роберт Иванович	m
Хороля Дмитрий Оттович	m
Киц Александр Владимирович	m
Ситнов Виктор Владимирович	m
Эдель Игорь Олегович	m
Семёнов Виктор Александрович	m
Эверстов Михаил Ильич	m
Максакова Лариса Сергеевна	f
Дубровский Виктор Николаевич	m
Машкарин Владимир Петрович	m
Лебедев Андрей Ярославович	m
Волков Андрей Романович	m
Пугачева Наталья Васильевна	f
Сухарев Иван Константинович	m
Хуснутдинов Наиль Кадырович	m
Черепков Виктор Иванович	m
Носовко Геннадий Сергеевич	m
Родионов Юрий Николаевич	m
Федоров Евгений Алексеевич	m
Потапенко Александр Федорович	m
Емельянов Михаил Васильевич	m
Свинин Сергей Васильевич	m
Жирков Егор Петрович	m
Бичелдей Каадыр-оол Алексеевич	m
Савельева Ирина Валентиновна	f
Деньгин Вадим Евгеньевич	m
Лебедев Александр Евгеньевич	m
Ледков Григорий Петрович	m
Цапин Александр Иванович	m
Губарева Наталья Викторовна	f
Афендулов Сергей Алексеевич	m
Журавлев Виталий Евгеньевич	m
Беклемищева Ольга Алексеевна	f
Медведев Евгений Николаевич	m
Воевода Юрий Евгеньевич	m
Аринин Александр Николаевич	m
Бабич Михаил Викторович	m
Александров Алексей Иванович	m
Петраков Николай Яковлевич	m
Васильев Михаил Аркадиевич	m
Камалов Хамит Искарович	m
Семаго Владимир Владимирович	m
Дубровская Татьяна Борисовна	f
Абдулатипов Рамазан Гаджимурадович	m
Шкуро Станислав Иванович	m
Гайнуллина Фарида Исмагиловна	f
Ищенко Евгений Петрович	m
Берулава Михаил Николаевич	m
Андреев Андрей Анатольевич	m
Кузнецов Юрий Павлович	m
Валуев Николай Сергеевич	m
Пашуто Владимир Ростиславович	m
Магомедов Станислав Юнусович	m
Таскаев Владимир Павлович	m
Барыкин Анатолий Петрович	m
Сафонов Александр Николаевич	m
Асеев Владимир Михайлович	m
Шестаков Владимир Афанасьевич	m
Локтионов Николай Игоревич	m
Бородин Виктор Иванович	m
Затулин Константин Федорович	m
Мормин Сергей Валерьевич	m
Ищенко Антон Анатольевич	m
Ткачев Алексей Николаевич	m
Кущев Вячеслав Митрофанович	m
Вернигора Владимир Сергеевич	m
Якушев Валерий Васильевич	m
Зубкевич Ирина Борисовна	f
Драганов Валерий Гаврилович	m
Ковалев Олег Иванович	m
Брыксин Александр Юрьевич	m
Солуянов Андрей Владимирович	m
Волков Владимир Николаевич	m
Киселев Михаил Михайлович	m
Воробьёв Андрей Юрьевич	m
Роднина Ирина Константиновна	f
Нигкоев Сергей Георгиевич	m
Пономарев Лев Александрович	m
Кирпичников Валерий Александрович	m
Власов Юрий Петрович	m
Шингаркин Максим Андреевич	m
Острягин Анатолий Иванович	m
Волков Данил Владимирович	m
Насташевский Святослав Анатольевич	m
Громов Борис Всеволодович	m
Блохин Евгений Евгеньевич	m
Луговой Андрей Константинович	m
Опекунов Виктор Семенович	m
Хор Глеб Яковлевич	m
Михеев Сергей Владимирович	m
Уткин Владимир Петрович	m
Злобина Лариса Афанасьевна	f
Абраменков Дмитрий Николаевич	m
Семенов Бато Цырендондокович	m
Денисенко Олег Иванович	m
Сычев Валерий Александрович	m
Грешневиков Анатолий Николаевич	m
Соболев Виктор Васильевич	m
Толбоев Магомед Омарович	m
Наумов Владимир Иванович	m
Крупенников Владимир Александрович	m
Журавлев Владимир Клавдиевич	m
Бунич Павел Григорьевич	m
Гитин Виктор Владимирович	m
Карелин Герман Юрьевич	m
Фалалеев Сергей Николаевич	m
Свергунова Маргарита Николаевна	f
Егоров Александр Кирьянович	m
Башмачников Владимир Федорович	m
Шаповалов Сергей Александрович	m
Таранцов Михаил Александрович	m
Маммаев Мамма Нурмагомедович	m
Орлова Светлана Юрьевна	f
Юрченко Сергей Иванович	m
Кумин Вадим Валентинович	m
Семенков Владимир Михайлович	m
Попов Михаил Иванович	m
Захаров Иван Васильевич	m
Дзасохов Александр Сергеевич	m
Юрьев Михаил Зиновьевич	m
Гималов Рафаэль Имамович	m
Дюдяев Геннадий Тимофеевич	m
Подберезкин Алексей Иванович	m
Фургал Сергей Иванович	m
Федяев Павел Михайлович	m
Волкогонов Дмитрий Антонович	m
Алтынбаев Жакслык Куантаевич	m
Чернышов Алексей Геннадиевич	m
Слиска Любовь Константиновна	f
Розуван Алексей Михайлович	m
Бойко Вячеслав Андреевич	m
Попкович Роман Семенович	m
Заполев Михаил Михайлович	m
Шугуров Расуль Игдисамович	m
Ульбашев Мухарби Магомедович	m
Потапов Александр Владимирович	m
Малышев Валерий Иванович	m
Амбарцумов Евгений Аршакович	m
Романович Александр Леонидович	m
Залиханов Михаил Чоккаевич	m
Еремеев Олег Витальевич	m
Кузьмина Алла Владимировна	f
Селезнев Валерий Сергеевич	m
Предыбайлов Виталий Митрофанович	m
Гнездилов Михаил Захарович	m
Бурков Александр Леонидович	m
Шелехов Александр Михайлович	m
Лебедь Алексей Иванович	m
Паршаков Юрий Николаевич	m
Барзыкин Юрий Александрович	m
Серебров Лев Борисович	m
Шабад Анатолий Ефимович	m
Колмаков Валерий Агафонович	m
Попов Виктор Михайлович	m
Овчинников Николай Александрович	m
Абрамов Виктор Семенович	m
Ганеев Мулланур Факразиевич	m
Марданшин Рафаэль Мирхатимович	m
Сухарев Сергей Владимирович	m
